13, 13, 13, 13, 13, 13, 13, 13, 13, 13, 13, 13, 13, 13, 13, 13, 13, 13, 13, 13
13, 0, 0, 0, 0, 0, 0, 0, 0, 0, 0, 0, 0, 0, 0, 0, 0, 0, 0, 13
13, 0, 0, 0, 0, 0, 0, 0, 0, 0, 0, 0, 0, 0, 0, 0, 0, 0, 8, 13
13, 0, 0, 0, 0, 0, 0, 0, 0, 0, 0, 0, 0, 7, 0, 10, 0, 13, 13, 13
13, 0, 0, 0, 7, 0, 0, 0, 0, 10, 0, 0, 0, 0, 0, 0, 0, 0, 0, 13
13, 7, 0, 10, 0, 15, 6, 6, 6, 6, 6, 6, 15, 0, 0, 0, 0, 0, 0, 13
13, 9, 0, 0, 0, 13, 15, 15, 15, 15, 15, 15, 13, 0, 0, 0, 0, 0, 0, 13
13, 0, 0, 0, 0, 0, 0, 0, 0, 0, 0, 0, 0, 0, 0, 0, 0, 0, 0, 13
13, 0, 9, 0, 0, 0, 0, 0, 0, 0, 0, 0, 0, 0, 0, 0, 0, 0, 0, 13
13, 0, 0, 0, 0, 0, 0, 0, 0, 7, 0, 0, 7, 0, 0, 0, 0, 0, 0, 13
13, 0, 0, 9, 0, 0, 0, 0, 0, 0, 0, 0, 0, 0, 0, 0, 0, 0, 0, 13
13, 0, 0, 0, 0, 0, 0, 0, 0, 10, 0, 0, 10, 0, 0, 0, 0, 0, 0, 13
13, 0, 0, 0, 15, 15, 6, 6, 6, 6, 6, 6, 6, 6, 6, 15, 15, 0, 0, 13
13, 0, 0, 15, 0, 15, 15, 15, 15, 15, 15, 15, 15, 15, 15, 0, 0, 0, 0, 13
13, 7, 0, 15, 0, 0, 0, 0, 0, 0, 0, 0, 0, 0, 0, 0, 0, 0, 9, 13
13, 15, 15, 0, 0, 0, 0, 0, 0, 0, 0, 0, 0, 0, 0, 0, 0, 0, 0, 13
13, 0, 0, 0, 0, 0, 0, 0, 0, 0, 7, 0, 0, 0, 7, 0, 15, 15, 15, 13
13, 0, 0, 0, 0, 15, 15, 0, 0, 10, 0, 0, 0, 10, 0, 0, 15, 13, 13, 13
13, 0, 0, 0, 13, 13, 15, 6, 6, 6, 6, 6, 6, 6, 6, 6, 15, 13, 13, 13
13, 13, 13, 13, 13, 13, 15, 15, 15, 15, 15, 15, 15, 15, 15, 15, 13, 13, 13, 13